xxxxxxxxxxxxxxxxxxxxxxxxxxxxxxxx
xS      x                   x Sx
xxxxxx  x                   x  x
x    x                      x  x
x                           x  x
x    x    xxxxxxx              x
x              Sx      xxxxxx  x
x    x          x              x
x               x              x
x    x           x            xx
x  x   x                     x x
x    x                        Sx
x     xxxxxxxxxxxxx         xx x
x                             xx
x                              x
x        xxxx                  x
x     xxxxxxxx                 x
x        S xxxxxxx             x
x                              x
xxxxxxxxxxxxxxxxxxxxxxxxxxxxxxxx