xxxxxxxxxxxxxxxxxxxxxxxxxxxxxxxx
xS      x                   x  x
xxxxxx  x          P        x Px
x  P x                      x  x
x                           x  x
x    x    xxxxxxx              x
x    P         Sx      xxxxxx  x
x    x          x              x
x               x              x
x    x           x           xxx
x  x   x                     x x
x    xxx                       x
x     xxxxxxxxxxxxx  P      xxPx
x                            xxx
x                              x
x        xxxx                  x
x     xxxxxxxx                 x
x          xxxxxxx             x
x                             Px
xxxxxxxxxxxxxxxxxxxxxxxxxxxxxxxx