xxxxxxxxxxxxxxxxxxxxxxxxxxxxxxxx
xS      x                   x Sx
xxxxxx  x                   x Px
x    x                      x  x
x                           x  x
x    x    xxxxxxx              x
x              Sx      xxxxxx  x
x    x          x              x
x               x              x
x    x           x           xxx
x  x   x                     x x
x    xxx                      Sx
x     xxxxxxxxxxxxx  P      xxPx
x                            xxx
x                              x
x        xxxx                  x
x     xxxxxxxx                 x
x        S xxxxxxx             x
x                             Px
xxxxxxxxxxxxxxxxxxxxxxxxxxxxxxxx