xxxxxxxxxxxxxxxxxxxxxxxxxxxxxxxx
xS############################Sx
x##############################x
x######xx######x###############x
x##############x###############x
x##############x###############x
xx############xx###############x
xxx#x#x##x#x#xxx########x######x
xxx#x#x##x#x#xxx########xx#####x
xx############xx########xx#####x
x#######################x######x
x##############x###############x
x######xx######x###############x
x######xx######x###############x
xS####xxxx####xx##############Sx
xxxxxxxxxxxxxxxxxxxxxxxxxxxxxxxx