################
################
################
x######xx######x
x##############x
x##############x
xx############xx
xxx#x#x##x#x#xxx
xxx#x#x##x#x#xxx
xx############xx
x##############x
x##############x
x######xx######x
x######xx######x
xx####xxxx####xx
xxxxxxxxxxxxxxxx