xxxxxxxxxxxxxxxx
x   x      x   x
x S x      x S x
x   x      x   x
x              x
x      xx      x
x              x
x   x  PP  x   x
x   x  PP  x   x
x              x
x      xx      x
x              x
x   x      x   x
x S x      x S x
x   x      x   x
xxxxxxxxxxxxxxxx
