xxxxxxxxxxxxxxxx
x   x      x   x
x S x      x S x
x   x      x   x
x              x
x              x
x              x
x              x
x   P      P   x
x              x
x              x
x              x
x              x
x   x      x   x
x S x      x S x
x   x      x   x
xxxxxxxxxxxxxxxx